/------\^/---------\
[$.....(-)...|..|..]
[.|.|..|..@..@.....]
[||||.....|.@.@|@|.]
[#|##|....||@.@....]
[#####....@...|...|]
[#####....|||@||@||]
[#|##|....@....|...]
<___}.....|..|@..@.]
^^^^[..|..@....@.@.]
^^^^[..|..|..|..|..]
^^^^<______________>