^^^^^^^^^^^^^^^^^^^^
^^^^^^^^^^^^^^^^^^^^
^^^^^^/-----\^^^^^^^
^^^^^^[.....(-\^^^^^
^^^^^/)@|||...]^^^^^
^^^^^[$..@..@.]^^^^^
^^^^^[.##|.@.{>^^^^^
^^^^^<}##|...]^^^^^^
^^^^^^<______>^^^^^^
^^^^^^^^^^^^^^^^^^^^
^^^^^^^^^^^^^^^^^^^^
^^^^^^^^^^^^^^^^^^^^