/------------------\
[..||||||...|||...#]
[..|....|@...@..###]
[.@|.$.....|||||###]
[..|..{_}@..|..|||{>
[.@||.]^[.@.|.@.#{>^
[...|.]^[@.....#{>^^
[@.@|.]^[.@.|.#{>^^^
[.....(-)@...#{>^^^^
[#@|........|{>^^^^^
[.#|........{>^^^^^^
<___________>^^^^^^^