^^^^^^^^^^^^^^^^^^^^
^^^^^^^^^^^^^^^^^^^^
^^^^^^/--\^^^^^^^^^^
^^^^^^[..(-\^^^^^^^^
^^^^^^[$...(-\^^^^^^
^^^^^^[.|@..#]^^^^^^
^^^^^^[.@.@##]^^^^^^
^^^^^^[.@.#{_>^^^^^^
^^^^^^[..{_>^^^^^^^^
^^^^^^<__>^^^^^^^^^^
^^^^^^^^^^^^^^^^^^^^
^^^^^^^^^^^^^^^^^^^^