^^^^^^^^^^^^^^^^^^^^
^^^^^^^^^/--\^^^^^^^
^^^^^^^^^[..]^^^^^^^
^^^^^^^^/)@.]^^^^^^^
^^^^^^/-)##.]^^^^^^^
^^^^^^[.@##.]^^^^^^^
^^^^^^[.@|.$]^^^^^^^
^^^^^^[.@...]^^^^^^^
^^^^^^[...{_>^^^^^^^
^^^^^^<___>^^^^^^^^^
^^^^^^^^^^^^^^^^^^^^
^^^^^^^^^^^^^^^^^^^^