/---------\^^^/----\
[.....|...]^^/)....]
[|.@..|...(--)..@..]
[|||.@@...|##|..|..]
[..@..@..||##||||.|]
[.@...|||####...@@.]
[..|@|...####|.|.@.]
[.|..|.@.##|||@|...]
[.|...@.|##|...||..]
[...@|..||||...|.@{>
[.|..|....$|......]^
<_________________>^