^^^^^^^^^^^^^^^^^^^^
^^^^/---\^^^^^^^^^^^
^^^^[...]^^^^^^^^^^^
^^^^[@..]^^^^^^^^^^^
^^/-)..@(\^^^^^^^^^^
^^[..@.@.]^^^^^^^^^^
/-).|.||.]^^^/----\^
[...|.||.(---)..##]^
[.@..@..........##]^
<___}.|||.|$||..##]^
^^^^[.....{_______>^
^^^^<_____>^^^^^^^^^