^^^^/----\^^/-\^^^^^
^^^^[##..]^/)$(\^^^^
^^^^[##..(-)...]^^^^
^^^^[##.....@@.]^^^^
^^^^[##..|.|.@.]^^^^
^^^^[##|||.|.@.]^^^^
^^^^<__}.@.|@..]^^^^
^^^^^^^[..@|.@.]^^^^
^^^^^^^[.@..@..]^^^^
^^^^^^^[..||...]^^^^
^^^^^^^<_______>^^^^
^^^^^^^^^^^^^^^^^^^^