^^^^^^^^^^^^^^^^^^^^
^^^^^^^^^^^^^^^^^^^^
^^^^^^^/--\^^^^^^^^^
^^^^^^^[.$(-\^^^^^^^
^^^^^^^[.@..]^^^^^^^
^^^^^^/)|.|.(\^^^^^^
^^^^^^[#|.|..]^^^^^^
^^^^^^[#@..|.]^^^^^^
^^^^^^[#...@.]^^^^^^
^^^^^^<______>^^^^^^
^^^^^^^^^^^^^^^^^^^^
^^^^^^^^^^^^^^^^^^^^