^^^^^^^^^^^^^^^^^^^^
^^^^^^^^^^^^^^^^^^^^
^^^^^^^^/-----\^^^^^
^^^^^^^/)..|..]^^^^^
^^^^^^^[...|.$]^^^^^
^^^^^^^[@.@.@.]^^^^^
^^^^^^^[.@||..]^^^^^
^^^^^/-).@.|.{>^^^^^
^^^^^[#####..]^^^^^^
^^^^^<_______>^^^^^^
^^^^^^^^^^^^^^^^^^^^
^^^^^^^^^^^^^^^^^^^^