^^^^^^^^^^^^^^^^^^^^
^^^/----------\^^^^^
^^^[##..|.....(-\^^^
^^^[##..|.@..@..]^^^
^^^[##..|@||||..]^^^
^^^[##....$.||..]^^^
^^^[##..|.|..@.|]^^^
^^^<_}|||.||@.@.]^^^
^^^^^[.@..@.@.@.]^^^
^^^^^[....|.....]^^^
^^^^^<__________>^^^
^^^^^^^^^^^^^^^^^^^^