^^^^/-------\^^^^^^^
^^^^[.......]^^^^^^^
^^^^[..@...@]^^^^^^^
^^^^<__}....]^^^^^^^
^^^^^^^[.@..(\^^^^^^
^^^^/--)...@.]^^^^^^
^^^^[##.@.||.(--\^^^
^^^^[##..@||....]^^^
^^^^[##....@....]^^^
^^^^[#{_}@|||.|$]^^^
^^^^[#]^[.....{_>^^^
^^^^<_>^<_____>^^^^^