^^^^^^^^^^^^^^^^^^^^
^^^^^^^^^^^^^^^^^^^^
^^^^^/------\^^^^^^^
^^^^^[....$.]^^^^^^^
^^^^^[.@##..(\^^^^^^
^^^^^<_}##|..]^^^^^^
^^^^^^^<}@@@.]^^^^^^
^^^^^^^^[....]^^^^^^
^^^^^^^^<____>^^^^^^
^^^^^^^^^^^^^^^^^^^^
^^^^^^^^^^^^^^^^^^^^
^^^^^^^^^^^^^^^^^^^^