^^^^^^^^^^^^^^^^^^^^
^^^^^^/---\^^^^^^^^^
^^^^^^[$..]^^^^^^^^^
^^^^^^[.@@]^/-\^^^^^
^^^^^^[.@.]^[#]^^^^^
^^^^^^<}|.(-)#]^^^^^
^^^^^^^[|....#]^^^^^
^^^^^^^[...|..]^^^^^
^^^^^^^[...{__>^^^^^
^^^^^^^<___>^^^^^^^^
^^^^^^^^^^^^^^^^^^^^
^^^^^^^^^^^^^^^^^^^^