^^^^^^^^^^^^^^^^^^^^
^^^^^^^^^^^^^^^^^^^^
^^^^^^^^/--\^^^^^^^^
^^^^^^^/)..]^^^^^^^^
^^^^^^^[$@.]^^^^^^^^
^^^^^^^[|@.(\^^^^^^^
^^^^^^^[|.@.]^^^^^^^
^^^^^^^[#@..]^^^^^^^
^^^^^^^[##*#]^^^^^^^
^^^^^^^<____>^^^^^^^
^^^^^^^^^^^^^^^^^^^^
^^^^^^^^^^^^^^^^^^^^