^^^^^^^^^^^^^^^^^^^^
^^^^^^^^^/------\^^^
^^^^^^^^^[.....$]^^^
^^^^^^^^^[.@|@.{>^^^
^^^^^^^^^[.@..@]^^^^
^^^^^^^^^[|@.@.]^^^^
^/-------).@.|.(-\^^
^[####..||.@..@..]^^
^[|###....@..@...]^^
^[####..{________>^^
^<______>^^^^^^^^^^^
^^^^^^^^^^^^^^^^^^^^