^^^^^^^^^^^^^^^^^^^^
^^^^^^/-----\^^^^^^^
^^^/--).....]^^^^^^^
^^^[...#|||.]^^^^^^^
^^^[.|.|....(\^^^^^^
^^^[.|.@.@|#.]^^^^^^
^^^[.|..*..|.]^^^^^^
^^^[.#|@.@.|.]^^^^^^
^^^<}....|.|.(-\^^^^
^^^^[.|||#.$...]^^^^
^^^^[.....||...]^^^^
^^^^<__________>^^^^