/------------------\
[...|....|...|...|$]
[.@......@...@...|.]
[|.|||##||.|||.....]
[...|####|@|..@|||.]
[.@.|####|..@..@.@.]
[...|####|.|.|.@.@.]
[...||##||...|@|...]
[|@||....||..|..|@|]
[...@..@.....|..|..]
[...|....|...|.....]
<__________________>