^/-----------------\
/)###...||.|....|..]
[####.........@.||.]
[####|.|.|@|||@....]
[###|....|.......|.]
[|#|..|@.|.....@||.]
[..|..|.@.@.|||..@.]
[.....@..@.|..|.||.]
[|.|.||.|@@|.@|..|.]
[..|...@.@.|......|]
[....|.....|..|...$]
<__________________>