/----------\/--\^^^^
[...|..|$|.()..]^^^^
[.|.|..@....@..(-\^^
[.|....||||||.@..(-\
[...|..|####|..@@..]
[|@||@||####|......]
[......|####||@||@|]
[..@@..|####|......]
[.@..@..|..|..|||..]
<___}..@...@....@..]
^^^^[.|....|..|...{>
^^^^<_____________>^