/----------------\^^
[..|..||....|...$(-\
[|....@....|.@|||..]
[|@|.@.||@|.@.@....]
[...@|....@......||]
[.||...@.|||..|####]
[.|.@|.|.|.|.|####{>
[....@.@.|..|####{>^
[|@.|||..@.|####{>^^
[..|.@........{_>^^^
[......|.|....]^^^^^
<_____________>^^^^^