/----------------\^^
[................(\^
[.@|...@.||..@....]^
[....@|||....|.@@.]^
[#|||.....@.@.||..(\
[###|..|..|....|@..]
[##||@@||||.@..|...]
[###|......@.||..||]
[###@..|||..|....|.]
<}##..@|..||...||$.]
^<}#|..............]
^^<________________>