^^^^^^^^^^^^^^^^^^^^
^^^^^^^^^^^^^^^^^^^^
^^^^^^^^/-\^^^^^^^^^
^^^^^^^^[#]^^^^^^^^^
^^^^^^^^[.(--\^^^^^^
^^^^^^/-)@.@#]^^^^^^
^^^^^^[#@$.{_>^^^^^^
^^^^^^<__}@]^^^^^^^^
^^^^^^^^^[#]^^^^^^^^
^^^^^^^^^<_>^^^^^^^^
^^^^^^^^^^^^^^^^^^^^
^^^^^^^^^^^^^^^^^^^^