^^^^^^^^^^^^^^^^^^^^
^^^^^/-----\^^^^^^^^
^^^^^[...$.]^^^^^^^^
^^^^^[.@.|.(--\^^^^^
^^^^^[|.@|@###]^^^^^
^^^^^[...@.###]^^^^^
^^^^^[.||.@.{_>^^^^^
^^^^^[....@.]^^^^^^^
^^^^^<_}....]^^^^^^^
^^^^^^^<____>^^^^^^^
^^^^^^^^^^^^^^^^^^^^
^^^^^^^^^^^^^^^^^^^^