^^^^^^^^^^/---\^^^^^
^^^^/-----)...(\^^^^
^^^/).|..||.@@.]^^^^
^^^[....$....@.]^^^^
^^^[..@..|||...]^^^^
^^^[||.|||||@|{>^^^^
^^^[.@..|||.##]^^^^^
^^^[.@.@.@.###]^^^^^
^^^[....{_}###]^^^^^
^^^[.@@.]^[###]^^^^^
^^^[..{_>^<___>^^^^^
^^^<__>^^^^^^^^^^^^^