/------------------\
[#|................]
[#|..............|.]
[.|...........@..|.]
[.|..@.............]
[.|......$.......|.]
[.|..............|.]
[.|...........@..|.]
[.|..@...........|.]
[................|#]
[................|#]
<__________________>