^^^^^^^^^^^^^^^^^^^^
^/----------------\^
^[|#|#|#|#|#|#|#|#]^
^[#@.@.@.@.@.@....]^
^[|.|.|.|.|.|.|.|.]^
^[#@.....@.......@]^
^[|.|.|.|.|.|.|.|.]^
^[#........@...@..]^
^[|.|.|.|.|.|.|.|.]^
^[#..........@...$]^
^<________________>^
^^^^^^^^^^^^^^^^^^^^