^/----------------\^
^[................]^
^[.........|......]^
^[...|||||||......]^
^[...*.....|.@....]^
^[...|..#.$|.@....]^
^[...||....|.@....]^
^[....|....|......]^
^[....|....|...||.]^
^[....|||@||...|.#]^
^[..............##]^
^<________________>^