^^^^^^^^^^^^^^^^^^^^
^^^^^^/------\^^^^^^
^^^^^^[......]^^^^^^
^^^^^/).||||@]^^^^^^
^^^^^[....|..]^^^^^^
^^^^^[.@..@.$]^^^^^^
^^^^^[.@..|##]^^^^^^
^^^^^[....|##]^^^^^^
^^^^^[....{__>^^^^^^
^^^^^[....]^^^^^^^^^
^^^^^<____>^^^^^^^^^
^^^^^^^^^^^^^^^^^^^^