^^^^^/--------\^^^^^
^^^^/)#|......(--\^^
^^^/)##|.@..@.|..]^^
^^^[###|.||.@.|..]^^
^^^[#####..|@@...]^^
^^^[|####@....|@.]^^
^^^[|||.|||||||..]^^
^^^[...@........|]^^
^^^[..@.|..@|.@.|]^^
^^^[.@|||.@.|.@@.]^^
^^^[...$|..||....]^^
^^^<_____________>^^