^^^^^^^^^^^^^^^^^^^^
^^^^^^^^^^^^^^^^^^^^
^^^^^^^^^^^^^^^^^^^^
^^^^^/--------\^^^^^
^^^^/).$.|....(\^^^^
^^^^[.@.####@..]^^^^
^^^^[..@{__}.@.]^^^^
^^^^[...]^^[..{>^^^^
^^^^<___>^^<__>^^^^^
^^^^^^^^^^^^^^^^^^^^
^^^^^^^^^^^^^^^^^^^^
^^^^^^^^^^^^^^^^^^^^